===================================================================================================
===================================================================================================
===================================================================================================
========@==========================================================================================
===================================================================================================
===================================================================================================
===========@==@====================================================================================
===================================================================================================
===================================================================================================
===================================================================================================
=========22?2======================================================================================
==================2================================================================================
====P=============2================================================================================
==================2================================================================================
111111111111111111111111111111111111111111111111111111111111111111111111111111111111111111111111111